111111111111111111111111111111111111111
100000000000000000000000000000000000001
100000000000000000000000000000000000001
100000000000000000000000000000000000001
100000000000000000000000000000000000001
100000000000000100000111111100000000001
10000000000000110000011E111100000000001
100000000000011000000100111100000000001
100000000000110000000000111100000000001
100000000001100000000000111000000000001
100000000011000000000001110000000000001
100000000110000000000111100100000000001
100000001111111100000111101100000000001
100000011111111100000111111100000000001
100000000000011100000000000000000000001
100000000000011100000000000000000000001
100000000000011100000000000000000000001
100000000000000000000000000000000000001
10000CCCCCCCCCCCCCCCCCCCCCCCCCCCCC00001
100000000000000000000000000000000000001
1P0000000000000000000000000000000000001
111111111111111111111111111111111111111