1111111111111111111111
1E000000001000C0000001
10100101PP100010010101
1C10010010101010C1P101
1P0000000C00C0000000C1
1111111111111111111111
